111111111111111111111111111111111111111111111
111111111111111111111111111111111111111111111
111111111111111111111111111111111111111111111
111111111100000111111111111111111111111110000
111111000000000000111111111111111111111000000
111110000000000000001111111111111111000000000
111110000000000000000011111111111110000000000
111110000000100000000000111111111100000000111
111100000000000000000000011111111000000001111
111100001000000000001000001111111000000011111
111100000000000000000000000111111000000011111
111000000000000000000000000111111000000011111
111000000000000000000000000111111000000011111
111000000000000000000000001111111000000111111
111000000000001111111000011111111000000111111
111001000000111111111111111111111000000111111
111000000001111111111111111111111000001111111
111000000001111111111111111111111000001111111
111000000111111111111111111111111000001111111
111000000111111111111111111111111000001111111
111000000111111111111111111111111000001111111
111000001111111111111111111111100000001111111
111000001111111111111111111000000000001111111
111100001111111111111111100000000000001111111
111100001111111111100000000000000000001111111
111110001111111111100000000000000100001111111
111110000111111110000000000000000000001111111
111110000111111100000000000000000000001111111
111111000111111100000000001111110000001111111
111111000011111000000001111111111100000111111
111111100001110000011111111111111110000111111
111111100100000000111111111111111111000111111
111111100000000000111111111111111111000111111
111111100000000000111111111111111111000111111
111111110000000000111111111111111111000111111
111111111000000000011111111111111110000011111
111111111100000000000111111111111000000011111
111111111110000000000001111110000000000011111
111111111111000000000000000000000000000011111
111111111111100000000000000000000000000111111
111111111111111100000000000000000000011111111
111111111111111111000000000000000000111111111
111111111111111111110000000000011111111111111
111111111111111111111111111111111111111111111
111111111111111111111111111111111111111111111
