11111111111111111111111111111111
10111111111111100000000000000001
10011111111111000000000000000001
10001111111110000000000000000001
10000111111000000000000000000001
10000000000000000000000000000001
10000000000000000000000000000001
10000010000000000000000000000001
10000000000000010000000000000001
10000000000000000000000000110001
10000000000001000000000000110001
10000000000000000000000000110001
10000111000001000000000111000001
10000111000001000000000111010001
10000111000100000000000000000001
10000111000000000000001000000001
10000000000001000000000000000001
10000000000000000000000000000001
10000000000000000000011000000001
10000000000000000000011000000001
10000000000000000000011000000001
10000000000000001110000000000001
10000000000000001110000000000001
10000000000000001110000000000001
10000000000000001110000000000001
10000000000000000000000000000001
10000000000000000000000000000001
10000000000000000000000000000001
10000000000000000000000000000001
10000000000000000000000000000001
10000000000000000000000000000001
11111111111111111111111111111111
