1111111111111111111111111111111111111111111111111111111111111111
1111111111111111111111111111111111111111111111111111111111111111
1111111111111111111001111111111111111111111111111111111111111111
1111111111111111111001111111000011111111111111111111111111111111
1111111111111111110001111111101011111111111111111111111111111111
1111111111111111101110111111100011111111111111111111111111111111
1111111111111100011111111111110001111111111111111111111111111111
1111111111111000011111011111110000011111111111111001110011111111
1111111111000000011111011111110000011111111111100010110011111111
1111111111010000001110111111111000000001111100000000000001111111
1111111110000000000001111111111000001111000000001110100000111111
1111111100000000000111111111111100001111010000001110000000111111
1111111100000001111111111111111100001111100000000000000000111111
1111111100000011111111111110100000000000000000000000000000111111
1111111100000111111111111110000000000000000000000000000000111111
1111111100000111111111111111111100000000000000000000000010111111
1111111100000111111111111111111110000000000000000000000000111111
1111111100000111111111111111111110000000000000100000000001111111
1111111100000111111111111111111110000000000010000000000001111111
1111111100000011111111100111111111000000000000000111000001111111
1111111100000011111111001001111111000000000000011111100001111111
1111111000000001111110000000111111000000000010111111100001111111
1111110010000000111100000000111111001000001000111111100000111111
1111100000000000000000000000111111000000000001111111100000111111
1111100000000000000000000000000000000000000001111111100001111111
1111000000000000000000000000000000000000000001111111100001111111
1111000000000000000000000000111111000000000011111111100001111111
1111000000000000000000000001111111000000000001111111000001111111
1111000000010000000000000001111111001000000001111111000001111111
1111000000000100000100000011111110000000000000111110000001111111
1111100000000000000000000011111110011100000000000000000001111111
1111100000000000000000000011111110011100000000000000000001111111
1111101000000000000000000011111110011100000000000000000011111111
1111110000000000000000000011111110011100000000000000000011111111
1111110000000000000000000111111110010000000000000000100111111111
1111111001000000000000001111111100000000000000000000001111111111
1111111000000000000000001111111100000000000000000000011111111111
1111111100000101010000011111111000000000000000000001111111111111
1111111101000000001100111111111000000000000000010011111111111111
1111111100001101011000111111111000000000000000000111111111111111
1111111110001000001001111111110000000000000000001111111111111111
1111111111000101011011111111100000000000000000111111111111111111
1111111111010110110111111111100000001111110000111111111111111111
1111111111000000001111111111100000011111110000111111111111111111
1111111111100000001111111111000000111111111000111111111111111111
1111111111100000011111111111000000111111111000011111111111111111
1111111111101001111111111110000001111111111000011111111111111111
1111111111100011111111111100100011111111111100001111111111111111
1111111111001111111111110000000011111111111110000111111111111111
1111111100111111111111100000000011111111111110000001111111111111
1111111111111111111110000001000111111111111111000001111111111111
1111111111111111111110100000001111111111111111000000111111111111
1111111111111111111110000000011111111111111111100000011111111111
1111111111111111111000000000111111111111111111100000001111111111
1111111111111111100000000001111111111111111111101000000011111111
1111111111111110000000000111111111111111111111110000000001111111
1111111111111000010010011111111111111111111111111000000000111111
1111111100000010000000111111111111111111111111111111000000011111
1111111100010000000011111111111111111111111111111111000000001111
1111111110000000011111111111111111111111111111111111111000001111
1111111111111111111111111111111111111111111111111111111110111111
1111111111111111111111111111111111111111111111111111111111111111
1111111111111111111111111111111111111111111111111111111111111111
1111111111111111111111111111111111111111111111111111111111111111
